R 1920 1080
NO ./path_to_the_north_texture
SO ./path_to_the_south_texture
WE ./path_to_the_west_texture
EA ./path_to_the_east_texture
S ./path_to_the_sprite_texture
F 220,100,0
C 225,30,0

11111111111111111111111111111111111111
10000000000000000000000000000000011111
10000000000000000000000000000000011111
10000000100000000000000000000000001111
10000000000000000000000111100000000011
10000000000000000000000000000000011111
10000000000000000000000000000000011111
11000000000000000000000000000011111111
11100000000111100000000000000000001111
11110000000000000000000000000000111111
111110000000N0000000000000000000011111
10000000000000000000000000000000011111
10000000000000000000000000000000011111
11111111111111111111111111111111111111